3,3,3,3,3,3,3,3,3,3,3,3,3,3,3,3,3,3,3,3,3,3,3,3,3,3,2,2,2,2
3,0,0,0,0,0,0,0,0,0,0,0,0,0,0,0,0,0,0,0,0,0,0,0,0,0,2,2,2,2
3,0,0,0,0,0,0,0,0,0,0,104,0,0,0,0,104,0,0,0,0,0,0,0,0,0,2,2,2,2
3,0,0,0,0,0,106,0,107,0,0,0,0,0,0,0,0,0,0,0,0,0,0,1,0,0,2,2,2,2
3,0,0,0,1,1,1,1,1,1,0,0,0,0,0,0,0,0,1,0,104,0,0,2,0,0,0,0,0,2
3,0,0,0,2,2,2,2,2,2,0,0,0,0,0,0,0,0,2,0,0,0,106,2,0,0,0,0,0,2
1,1,1,1,2,2,2,2,2,2,0,0,106,0,0,106,0,0,2,1,1,1,1,2,0,0,0,0,0,2
2,2,2,2,2,2,2,2,2,2,1,1,1,1,1,1,1,1,2,2,2,2,2,2,1,1,1,0,0,2
2,2,2,2,2,2,2,2,2,2,2,2,2,2,2,2,2,2,2,2,2,2,2,2,2,2,2,0,108,2
2,2,2,2,2,2,2,2,2,2,2,2,2,2,2,2,2,2,2,2,2,2,2,2,2,2,2,1,1,2
2,2,2,2,2,2,2,2,2,2,2,2,2,2,2,2,2,2,2,2,2,2,2,2,2,2,2,2,2,2
2,2,2,2,2,2,2,2,2,2,2,2,2,2,2,2,2,2,2,2,2,2,2,2,2,2,2,2,2,2
