4,4,4,4,4,4,4,4,4,4,4,4,4,4,4,4,4,4,4,4,4,4,4,4,4,4,4,4,4,4,4,4,4,4,4,4,4,4,4,4,4,4,4,4,4,4,4,4,4,4,4,4,4,4,4,4,4,4,4,4,4,0,0,0,0,0,0
4,0,0,0,0,0,0,0,0,0,0,0,0,0,0,0,0,0,0,0,0,0,0,0,0,0,0,0,0,0,0,0,0,0,0,0,0,0,0,0,0,0,0,0,0,0,0,0,0,0,0,0,0,0,0,0,0,0,0,4,4,0,0,0,0,0,0
4,0,0,0,0,0,0,0,0,0,0,0,0,0,0,0,0,0,0,0,0,0,0,0,0,0,0,0,0,0,0,0,0,0,0,0,0,0,0,0,0,0,0,0,0,0,0,0,0,0,0,0,0,0,0,0,0,0,0,4,4,0,0,0,0,0,0
4,0,0,0,0,0,0,0,0,0,0,0,0,104,0,0,0,0,0,0,0,0,0,0,107,0,0,0,104,0,0,0,0,0,0,0,0,0,0,0,0,0,0,0,0,0,0,0,0,0,0,0,0,0,0,0,0,0,0,4,4,0,0,0,0,0,0
4,0,0,0,0,0,0,0,0,0,0,0,0,0,0,0,0,0,0,0,0,0,0,0,1,0,0,0,0,0,0,0,0,0,0,0,0,0,0,0,0,0,0,0,0,0,0,0,0,0,0,0,0,0,0,0,0,0,0,4,4,0,0,0,0,0,0
4,0,0,0,0,0,0,104,0,0,0,0,0,0,0,0,0,0,0,0,0,0,0,104,2,0,0,104,0,104,0,0,0,0,0,0,0,0,0,0,0,0,0,0,0,0,0,0,0,0,0,0,0,0,0,0,0,0,0,4,4,0,0,0,0,0,0
4,0,0,0,107,0,0,0,0,0,0,0,0,104,0,0,0,0,0,0,0,0,0,0,2,0,0,0,0,0,0,0,0,0,0,0,0,0,0,0,0,0,0,0,0,0,0,0,0,0,0,0,0,0,0,0,0,0,0,4,4,0,0,0,0,0,0
4,0,0,0,0,0,0,1,0,0,0,104,0,0,0,104,1,1,1,1,0,0,0,1,2,0,104,0,0,0,104,0,0,0,105,0,0,0,0,0,0,0,0,0,0,0,0,0,104,0,0,0,104,0,0,0,0,0,0,4,4,0,0,0,0,0,0
4,0,0,0,0,105,1,2,1,106,0,0,0,0,0,0,2,2,2,2,0,0,0,2,2,0,0,0,0,0,0,0,0,1,1,1,0,0,0,0,0,0,0,0,0,0,0,0,0,0,0,0,0,0,0,0,0,0,0,4,4,0,0,0,0,0,0
4,0,0,0,0,1,2,2,2,1,0,0,0,0,0,0,2,2,2,2,0,0,0,2,2,0,0,0,0,0,0,0,0,2,2,2,0,0,0,0,0,0,0,0,0,0,0,0,0,0,0,104,0,104,0,0,0,0,0,4,4,0,0,0,0,0,0
4,0,0,0,1,2,2,2,2,2,1,0,0,0,0,0,2,2,2,2,0,0,0,2,2,1,0,0,0,0,0,0,0,2,2,2,0,0,106,0,0,0,0,0,0,0,105,0,0,0,0,0,0,0,0,0,0,0,0,4,4,0,0,0,0,0,0
4,0,0,1,2,2,2,2,2,2,2,1,0,0,0,0,2,2,2,2,105,105,0,2,2,2,0,0,106,1,1,1,0,2,2,2,0,1,1,1,0,0,0,0,0,1,1,1,1,1,0,0,0,0,0,0,106,0,108,4,4,0,0,0,0,0,0
1,1,1,2,2,2,2,2,2,2,2,2,1,1,1,1,2,2,2,2,1,1,1,2,2,2,1,1,1,2,2,2,1,2,2,2,1,2,2,2,3,3,3,3,3,2,2,2,2,2,3,3,3,3,3,1,1,1,1,1,1,1,1,1,1,1,1
2,2,2,2,2,2,2,2,2,2,2,2,2,2,2,2,2,2,2,2,2,2,2,2,2,2,2,2,2,2,2,2,2,2,2,2,2,2,2,2,3,3,3,3,3,2,2,2,2,2,3,3,3,3,3,2,2,2,2,2,2,2,2,2,2,2,2
2,2,2,2,2,2,2,2,2,2,2,2,2,2,2,2,2,2,2,2,2,2,2,2,2,2,2,2,2,2,2,2,2,2,2,2,2,2,2,2,2,2,2,2,2,2,2,2,2,2,2,2,2,2,2,2,2,2,2,2,2,2,2,2,2,2,2
2,2,2,2,2,2,2,2,2,2,2,2,2,2,2,2,2,2,2,2,2,2,2,2,2,2,2,2,2,2,2,2,2,2,2,2,2,2,2,2,2,2,2,2,2,2,2,2,2,2,2,2,2,2,2,2,2,2,2,2,2,2,2,2,2,2,2
